....................
....................
....................
....................
....................
....................
....................
..........B.........
.........###........
....................
....................
....###.......###...
....................
B1........B.......X.
####################
