....................
....................
........B.......#:#.
.......######...#B#.
.................#..
####................
.............B......
......---:::--......
...--...........--..
....................
..................X.
####....~~~~....####
...........#........
.1.........#.B......
####################
