....................
....................
....................
........B.....B.....
.......#:#..-.-.....
.~...:.#.#..-.-.....
.......#.#..~.~.....
.......#.#..~B~.....
...--..#.#..~B~.....
.......#.#..#B#.....
.B.....#.#..#B#.....
####...#.#..#B#.....
.......#.#..#X#.....
.1......#....#......
####################
